NO ./textures/bluestone.xpm
SO ./textures/colorstone.xpm
WE ./textures/greystone.xpm
EA ./textures/redbrick.xpm

F 80,50,30
C 60,90,180

111111111111111111111
1000000000000000000E1
111111111111111111111
