NO ./textures/bluestone.xpm
SO ./textures/colorstone.xpm
WE ./textures/greystone.xpm
EA ./textures/redbrick.xpm

F 80, 50, 30
60, 90, 180

1111111111111111111111111
1000110000100000000000001
1000110000000000111111001
1000110000000000110001001
1000000000100S00000001001
1111111111111111111111111
